#.....................................................................................................#
#.....................................................................................................#
#.....................................................................................................#
#.....................................................................................................#
#........................................................................##########...................#
#.....................................................................................................#
#.....................................................................................................#
#.\...................................................................................................#
#..\......................................#####.......................................................#
#...\.................................................................................................#
#....\................................................................................................#
#.....\...............................................................................................#
#......\..............................................................................................#
#.......\.............................................................................................#
#........\............................................................................................#
#.........#####.......................................................................................#
#..............\......................#####...........................................................#
#...............\.....................................................................................#
#................\....................................................................................#
#.................\...................................................................................#
#..................\..............................................................##########..........#
#....................................................#................................................#
#.....................................................................................................#
#.....................#####...........................................................................#
#.....................................................................................................#
#.....................................................................................................#
#.....................................................................................................#
#.............................................#####...................................................#
#.....................................................................................................#
#.....................................................................................................#
#.....#.#..#..#####...................................................................................#
#..................#.......................................................#..........................#
#...................#.................................................................................#
#....................#................................................................................#
#.....................#....................................#..........................................#
#......................#..............................................................................#
#.......................#.............................................................................#
#........................#............................................................................#
#.........................#...........................................................................#
#######################################################################################################