#...........................................................#
#...........................................................#
#.#.........................................................#
#..#........................................................#
#...#.......................................................#
#....#......................................................#
#...........................................................#
#...........................................................#
#.........................................#####.............#
#...........................................................#
#...........................................................#
#...........................................................#
#...........................................................#
#...........................................................#
#...........................................................#
#.........#####.............................................#
#.....................................#####.................#
#...........................................................#
#...........................................................#
#...........................................................#
#...........................................................#
#...........................................................#
#...........................................................#
#.....................#####.................................#
#...........................................................#
#...........................................................#
#...........................................................#
#.............................................#####.........#
#...........................................................#
#...........................................................#
#.............#####.........................................#
#..................#........................................#
#...................#.......................................#
#....................#......................................#
#.....................#.....................................#
#......................#....................................#
#.......................#...................................#
#........................#..................................#
#.........................#.................................#
#############################################################